11011100001111111111111111111100000
10111000111111111111111111111111000
01100011111111111111111111111111100
01000111111111111111111111111111110
11001111111111111111111111111111111
10011110001111111111111111111111011
10111100000011111111111111111111100
00111100000000111111111111111111111
01111000001111000111111111111111110
01111000011000100001111111111111000
11111000110000000000001111111000000
11110000110000000000000000000000000
11110000000000000000000000100000000
11110000000111110000001110100000000
11111000001111011000011011100000000
11111000011101101000010101110000000
11111100011110101000011101111000000
11111100011010101000011111001000000
11000110011111101000111100011000000
10010110001111011001100000111100000
10111010000111110001000011101100000
10101010000000000001101110000100000
10000000000000000000111000000100000
11000000000000100000000011001100000
11100010000001111111111110001100000
11111111000011110000001110011000000
11111111100000111100000100011000000
01111111110000001111111110110000000
00111111111100000000000011100000000
00001111101111000001111111000000000
00000001100111110000001110000000000
00000011110001111111111000000000000
00000011111100011110000111100000000
00001111000111111111111100110000000
00111100000011110000111000010000000
11111000000000110000010000010000000
11111000001111110000011110010000000
11111000001100100000010110011000000
11111000000001111000110000011100000
11111100000111111111111100111110000