11111111111111111111
00000000000000000000
00000000000000000001
00000000000000000000
00000000000000000001
00000000000000000000
00000000000000000001
00000000000000000000
00000000000000000001
00000000000000000000
00000000000000000001
00000000000000000000
00000000000000000001
00000000000000000000
00000000000000000001
00000000000000000000
00000000000000000001
00000000000000000000
10101010101010101010
11111111111111111111
00000000000000000000
11111111111111111111
